111111111111111111111111111111111
1p...1..1.m......m.1...1........1
1....1..1.......11..1..m......m.1
1......m...11......11.....1.....1
1...........11111111....1111.1111
11111............m.....1.m..1...1
1.......1....m.........1...1..m.1
1....m.............m...1..1.....1
111111......111111111111....m...1
1..m.....m....1....m............1
1.....1.......1...........1111..1
1.....1.......1...m.....11......1
1.....1....m........1111....m...1
1..m..1.......m...11.....m.111111
1....11111..111111...m....1..1..1
1....1.......1..m....m..11......1
1.m..1...m...1..m...1111...m..1.1
1....1.......1...111..m..1.....11
1....1..m....1.m.1...11111..1...1
1..m.1.......1......1....11111..1
111111.m..11111..m.1..111..m....1
1...m....1....1..111..m...1111111
1.......1..m..1111.m..111.....1.1
1.m....1......1..1....m....m..1.1
1..1111...m...1111..1.1...m.....1
1...m.1.......1..1..1.1......m..1
1..m..1...11...1.1111..11111111.1
1...m...m..1.....m.........1.m..1
111111111111111111111111111111111
